S0 . . . . G .
.  . . . G . .
.  . . . . . .
G  . X G X G G
.  . . . . . .
G  G . . G . .
G  . . . . . S1