. . . . . . . . . .
. . . . . . . . . @
. . . . . . . . @ .
. . . . . . . . . .
. . @ . . . . . . S0
. . @ . . . . . . X
. . @ . . . @ . . .
. . @ . . . @ . . .
. . @ . . . @ . @ @
. . . . . . @ . . .